1
#############
#p*  #  #   #
# #  #  g   #
# #  ** # * #
# *#s   f   #
#           #
#       #   #
#   *       #
# # b       #
#   #  ##   #
# # # #  #  #
#   *    1  #
#############